{
 "format": "dc2d-map",
 "version": 1,
 "tileSize": 32,
 "sheet": "tilesheet.png",
 "sheetCols": 32,
 "origin": { "x": 68, "y": 12 },
 "width": 7,
 "height": 6,
 "logic": [
  1, 1, 1, 1, 1, 1, 1,
  1, 0, 0, 0, 0, 0, 1,
  1, 0, 0, 0, 0, 0, 1,
  1, 0, 0, 0, 0, 0, 1,
  1, 1, 1, 1, 1, 1, 1,
  1, 1, 1, 8, 1, 1, 1
 ],
 "art": [
  289, 290, 290, 290, 290, 290, 291,
  321,  41,  42,  41,  42,  41, 323,
  321,  73,  74,  73,  74,  73, 323,
  321,  41,  42,  41,  42,  41, 323,
  353, 354, 354, 354, 354, 354, 355,
  385, 386, 386, 386, 386, 386, 387
 ],
 "flattenTo": 0
}
